[ [11, 1],
  [26, 2],
  [25, 2],
  [21, 2],
  [22, 2],
  [24, 2],
  [23, 2],
  [31, 3],
  [41, 4],
  [42, 4],
  [43, 4],
  [51, 5],
  [52, 5],
  [53, 5],
  [54, 5],
  [61, 6],
  [62, 6],
  [63, 6],
  [71, 7],
  [72, 7],
  [81, 8],
  [82, 8],
  [83, 8],
  [84, 8],
  [85, 8],
  [91, 9],
  [92, 9],
  [93, 9],
  [94, 9],
  [95, 9],
  [96, 9],
  [97, 9],
  [101, 10],
  [102, 10],
  [103, 10],
  [104, 10],
  [105, 10],
  [111, 11],
  [112, 11],
  [113, 11],
  [114, 11],
  [115, 11],
  [116, 11],
  [117, 11]
]
